1111111111111111111111111111111111
10000C0000000001000000000000100001
10000000000000000000000C0000000001
1000001000000000000000000000000001
10000000000PE000000000000000000001
100000000000000000000000C000000001
1000000000000000000000000000000001
100001000000C000000000000000100001
1111111111111111111111111111111111